XPXXXXXXXXXXXXXXXXXXXXXXXXXXXXXXX
X                               X
XXXXXXXXXXXXXXXXXXXXXXXXXXXXXXX X
X                               X
X XXXXXXXXXXXXXXXXXXXXXXXXXXXXXXX
X                               X
XXXXXXXXXXXXXXXXXXXXXXXXXXXXXXX X
X                               X
X XXXXXXXXXXXXXXXXXXXXXXXXXXXXXXX
X                               X
XXXXXXXXXXXXXXXXXXXXXXXXXXXXXXX X
X                               X
X XXXXXXXXXXXXXXXXXXXXXXXXXXXXXXX
X                               X
XXXXXXXXXXXXXXXXXXXXXXXXXXXXXXX X
X                               X
XEXXXXXXXXXXXXXXXXXXXXXXXXXXXXXXX
